1111111111111111111111111111111111
1111111111111111111111111111110001
1111111111111100000C11111111111111
1111111111111100111111111111111111
1111111C11111100111111111111111111
111111EPC0000000111111111111111111
1111111111111111111111111111111111