11111111111111111111111111111
1P000000000000000C000000000C1
10111111101111111111110111001
10000000100000000000C10001001
10111110111011111111010001001
10100C101000101000C1010001001
10101110101110101111011111001
101000001000C010000000C100011
10101111101110101111101101001
1010000C100000000000000001001
101111111111111111111101110C1
1C0000000000000010000001C1111
10111011111110111011110001001
1010000C100000100000C11101C01
10101111101111101111110001001
10100000000000000000010111001
10101111111111111111110001011
100000000000000000000001000E1
11111111111111111111111111111